11111
10001
1E001
100C1
10P01
11111