1111111111111111
10C00000000000P1
1001111100011111
100000C100000101
1000111111100101
1000000000001101
100C010111001001
1000010001000011
1000011111000011
1110010000000001
1C00010000000C01
1001110001111111
100001000001C001
1010010000000001
10C000000000E001
1111111111111111