11111111
10010C01
1P000001
10001111
100010C1
11101001
1C100001
10001001
11111001
1E000001
11111111