111111
1C0001
1000E1
100001
100P01
111111