111111
100P101
1000001
1C001
10001
111


