111111
100P11
100001
1C0001
1000E1
110111