111111
100P101
1000001
1C01001
1000E01
111111