111111111
100010E01
100011111
100000001
1000000C1
1C0000001
100000P01
111111111