111111111
100010C01
100011111
100000001
1000000E1
1C0000001
100000P01
111111111