1111111111111111
10000000000000P1
1001111100011111
1000000100000101
1000111111100101
1000000000001101
1000010111001001
1000010001000011
1000011111000011
1110010000000001
1000010000000001
1001110001111111
1000010000000001
1010010000000001
100000000000E001
1111111111111111