11111
10001
10001
10001
10P01
11101
10001
10111
10111
10111
10001
11111