11111111
100E000111111
10000000000P1
111C000111111
11111111