11111011
10000001
10000111
11100001
11111111